3 13 20
####################
#p     #* *  3 * 2 #
# # # #*# # #*#*#  #
#   *    *s*** *  1#
# # # # # #*# # #*##
#f    3       **  *#
# # # # # # # # # ##
#*  *   2  *  *    #
# # # # #*# # # #* #
#*f   **  *   3   *#
# #*# # # # # # #*##
#    2     x*  *  #
####################
