3 13 20
####################
#p     #* *b* 3 * 2#
# # # #*# # #*#*#  #
#   * 5  *s*** *  1#
# # # # # #*# # #*##
#f*   3   4  *f*  *#
# # # # # # # # # ##
#*  *   2  *  *    #
# # # # #*# # # #* #
#*f 4 **  *   3   *#
# #*# # # # # # #*##
#    2  5  x*  **  #
####################
