2 13 20
####################
#p      * *  1 * 2 #
# # # #*# # #*#*#  #
#   *    **s*  *  1#
# **# # # #*# # #*##
#f    1   5   **  *#
# # # # #*# # # # ##
#* s*  *2  *  *    #
# # # # #*# # #f#* #
#* 2  **  * 4  5  *#
# #*# # # # # # #*##
#    3      x*  *  #
####################
