3 13 31
###############################
#p       *    **   1  *       #
# # # #s# # # # # #*# #*# # # #
#    *        **        1     #
# #b# # # #*# # #*# # # # # #*#
#f *        *x        *       #
# # # # # # # # # #*# # # # # #
#     *  *        **b         #
#*#*# # # # #*# # # # # # #*# #
#    *f          *      *     #
# # # # # #*# #2#*# # # #*# # #
#*  3   *        *        *   #
###############################