2 13 31
###############################
#p     b* *   2*   *  * * *   #
# # # # # # #*#*# # # #*#*#*# #
#   *  *f * *  *    1 *   * * #
# #b# #x# #*# # #*#*# # # # #*#
#f   s       **  *  *         #
# # # # # # # # # #*# #*# # # #
#*  *   s  *  *      *        #
# # # # #*# # # #*#*# # # # # #
#* 1  **  *       *      3    #
# #*# # # # # # #*# # # # # # #
#         1 *   *  *          #
###############################