2 13 20
####################
#p      * *  1 * 2 #
# # # #*# # #*#*#  #
#   *    **s*  *  1#
# **# # # #*# # #*##
#f    1       **  *#
# # # # #*# # # # ##
#* s*  *2  *  *    #
# # # # #*# # #f#* #
#*    **  *       *#
# #*# # # # # # #*##
#    3      x*  *  #
####################
